
1,2,3,4,5

1,2,2,1,1



     1,1,1,1,1
1,1,1,1,1      
   1,1,1,1,1 
1,1,1,1,1
195,195,195,195,195
